6
12
. . . . . . . . . . . .
. 1 1 3 4 1 2 3 4 1 2 .
. 2 . 4 1 2 3 4 1 . 1 .
. 1 1 1 1 1 1 1 1 1 1 .
. 1 1 1 . . . . 1 1 1 .
. 1 1 1 1 1 1 1 1 1 1 .